0200011121
2222222222
1211111121
1211111121
1211111121
1201001021
2222222221
1201111121
2222222222
0200000021