3334423343
3433324333
3334322433
3343442234
4333343233
3343334233
3434334234
3433422243
3434324333
3334324333