5225655252
2225562252
5525665555
5225655255
5255255552
5255222525
5525565555
5255566665
5252255266
5525555525